F 220,100,0
C 225,30,0

                1111111111111
                111111111111111
                1111111111111111111
             1111111111111111111111111
             10000000001100001
             10110000000000001
             10010000000000001
111111111111110001110000000001
100000000011000001110111111111111
11110111111111011100000010001
11110111111111011101010010011
11000000110101011100000100011
10000000000000001100000010001
100000000000000110110N000011
11000001110101011111010010111
11110111 1110101 101111010001
11111111 1111111 111111111111
