    NO      imgs/wall1.xpm          

                          SO imgs/wall2.xpm   

   F 220,100,0
                  C 225,30,0

  WE imgs/wall3.xpm         

   EA            imgs/wall4.xpm



             11111
  1111111              111111111111
  10N001         1111111111111111111
   11111      1111111111111111111111111
             10000000001100001
   11      11110110000000000001111
1   1     100010010000000000001
1111111111111100011100000000011111
100000000011000001110111111111111
11110111111111011100000010001
1111011111111101110101001001
1100000011010101110000100001
1000000000000001100000010011
1000000000000001101100000111
11000001110101011111010000111
11110111 1110101 101111010001
11111111 1111111 11111111111
